⬛⬛⬛⬛⬛⬛⬛⬛⬛⬛⬛⬛⬛⬛⬛⬛⬛⬛⬛
⬛😐⬜⬜⬜⬜🍎⬜⬜⬛⬜⬜🍎⬜⬜⬜⬜⬜⬛
⬛⬜⬛⬛⬜⬛⬛⬛⬜⬛⬜⬛⬛⬛⬜⬛⬛⬜⬛
⬛⬜⬛⬛⬜⬛⬛⬛⬜⬛⬜⬛⬛⬛⬜⬛⬛⬜⬛
⬛⬜⬜⬜⬜⬜⬜⬜⬜⬜⬜⬜⬜⬜⬜⬜⬜⬜⬛
⬛⬜⬛⬛⬜⬛⬜⬛⬛⬛⬛⬛⬜⬛⬜⬛⬛⬜⬛
⬛⬜⬜⬜⬜⬛⬜⬜⬜⬛⬜⬜⬜⬛⬜⬜⬜⬜⬛
⬛⬛⬛⬛⬜⬛⬛⬛⬜⬛⬜⬛⬛⬛⬜⬛⬛⬛⬛
⬛⬛⬛⬛⬜⬛⬜⬜⬜🍎⬜⬜⬜⬛⬜⬛⬛⬛⬛
⬛⬛⬛⬛⬜⬛⬜⬛⬜⬜⬜⬛⬜⬛⬜⬛⬛⬛⬛
👌⬜🍎⬜⬜⬜⬜⬛⬜😈⬜⬛⬜⬜⬜⬜🍎⬜👌
⬛⬛⬛⬛⬜⬛⬜⬛😡⭐📘⬛⬜⬛⬜⬛⬛⬛⬛
⬛⬛⬛⬛⬜⬛⬜⬜⬜⬜⬜⬜⬜⬛⬜⬛⬛⬛⬛
⬛⬛⬛⬛⬜⬛⬜⬜⬜🍒⬜⬜⬜⬛⬜⬛⬛⬛⬛
⬛⬛⬛⬛⬜⬜⬜⬛⬛⬛⬛⬛⬜⬜⬜⬛⬛⬛⬛
⬛⬜⬜⬜⬜⬜⬜⬜⬜⬛⬜⬜⬜⬜⬜⬜⬜⬜⬛
⬛⬜⬛⬛⬜⬛⬛⬛⬜⬛⬜⬛⬛⬛⬜⬛⬛⬜⬛
⬛⬜⬜⬛⬜⬜⬜⬜⬜⬜⬜⬜⬜⬜⬜⬛⬜⬜⬛
⬛⬛⬜⬛⬜⬛⬜⬛⬛⬛⬛⬛⬜⬛⬜⬛⬜⬛⬛
⬛⬜⬜⬜⬜⬛⬜⬜⬜⬛⬜⬜⬜⬛⬜⬜⬜⬜⬛
⬛⬜⬛⬛⬛⬛⬛⬛⬜⬛⬜⬛⬛⬛⬛⬛⬛⬜⬛
⬛⬜⬜⬜⬜🍎⬜⬜⬜⬜⬜⬜⬜🍎⬜⬜⬜⬜⬛
⬛⬛⬛⬛⬛⬛⬛⬛⬛⬛⬛⬛⬛⬛⬛⬛⬛⬛⬛