⬛⬛⬛⬛⬛⬛⬛⬛⬛⬛⬛⬛⬛⬛⬛⬛⬛⬛⬛
⬛😐⬜⬜⬜⬜🍎⬜⬜⬛⬜⬜🍎⬜⬜⬜⬜⬜⬛
⬛⬜⬛⬛⬜⬛⬛⬛⬜⬛⬜⬛⬛⬛⬜⬛⬛⬜⬛
⬛⬜⬛⬛⬜⬛⬛⬛⬜⬛⬜⬛⬛⬛⬜⬛⬛⬜⬛
⬛⬜⬜⬜⬜⬜⬜⬜⬜⬜⬜⬜⬜⬜⬜⬜⬜⬜⬛
⬛⬜⬛⬛⬜⬛⬜⬛⬛⬛⬛⬛⬜⬛⬜⬛⬛⬜⬛
⬛⬜⬜⬜⬜⬛⬜⬜⬜⬛⬜⬜⬜⬛⬜⬜⬜⬜⬛
⬛⬛⬛⬛⬜⬛⬛⬛⬜⬛⬜⬛⬛⬛⬜⬛⬛⬛⬛
⬛⬛⬛⬛⬜⬛⬜⬜⬜🍎⬜⬜⬜⬛⬜⬛⬛⬛⬛
⬛⬛⬛⬛⬜⬛⬜⬛⬜⬜⬜⬛⬜⬛⬜⬛⬛⬛⬛
👌⬜🍎⬜⬜⬜⬜⬛⬜😈⬜⬛⬜⬜⬜⬜🍎⬜👌
⬛⬛⬛⬜⬜⬛⬜⬛😡⭐📘⬛⬜⬛⬜⬜⬛⬛⬛
⬛⬜⬛⬜⬜⬛⬜⬜⬜⬜⬜⬜⬜⬛⬜⬜⬛⬜⬛
⬛⬜⬛⬜⬜⬛⬜⬜⬜🍒⬜⬜⬜⬛⬜⬜⬛⬜⬛
⬛⬜⬛⬜⬜⬜⬜⬛⬛⬛⬛⬛⬜⬜⬜⬜⬛⬜⬛
⬛⬜⬜⬜⬜⬜⬜⬜⬜⬛⬜⬜⬜⬜⬜⬜⬜⬜⬛
⬛⬜⬛⬛⬜⬛⬛⬛⬜⬛⬜⬛⬛⬛⬜⬛⬛⬜⬛
⬛⬜⬜⬛⬜⬜⬜⬜⬜⬜⬜⬜⬜⬜⬜⬛⬜⬜⬛
⬛⬛⬜⬛⬜⬛⬜⬛⬛⬛⬛⬛⬜⬛⬜⬛⬜⬛⬛
⬛⬜⬜⬜⬜⬛⬜⬜⬜⬛⬜⬜⬜⬛⬜⬜⬜⬜⬛
⬛⬜⬛⬛⬛⬛⬛⬛⬜⬛⬜⬛⬛⬛⬛⬛⬛⬜⬛
⬛⬜⬜⬜⬜🍎⬜⬜⬜⬜⬜⬜⬜🍎⬜⬜⬜⬜⬛
⬛⬛⬛⬛⬛⬛⬛⬛⬛⬛⬛⬛⬛⬛⬛⬛⬛⬛⬛