⬛⬛⬛⬛⬛⬛⬛⬛⬛⬛⬛⬛⬛⬛⬛⬛⬛⬛⬛
⬛😐⬜⬜⬜⬜⬜⬜⬜⬛⬜⬜⬜⬜⬜⬜⬜⬜⬛
⬛⬜⬛⬛⬜⬛⬛⬛⬜⬛⬜⬛⬛⬛⬜⬛⬛⬜⬛
⬛⬜⬛⬛⬜⬛⬛⬛⬜⬛⬜⬛⬛⬛⬜⬛⬛⬜⬛
⬛⬜⬜⬜⬜⬜⬜⬜⬜🍎⬜⬜⬜⬜⬜⬜⬜⬜⬛
⬛⬜⬛⬛⬜⬛⬜⬛⬛⬛⬛⬛⬜⬛⬜⬛⬛⬜⬛
⬛⬜⬜⬜⬜⬛⬜⬜⬜⬛⬜⬜⬜⬛⬜⬜⬜⬜⬛
⬛⬛⬛⬛⬜⬛⬛⬛⬜⬛⬜⬛⬛⬛⬜⬛⬛⬛⬛
⬛⬛⬛⬛⬜⬛⬜⬜⬜🍎⬜⬜⬜⬛⬜⬛⬛⬛⬛
⬛⬛⬛⬛⬜⬛⬜⬜⬜⬜⬜⬜⬜⬛⬜⬛⬛⬛⬛
💛⬜⬜⬜⬜⬜⬜⬜⬜😈⬜⬜⬜⬜⬜⬜⬜⬜💛
⬛⬛⬛⬛⬜⬛⬜⬜😡⭐📘⬜⬜⬛⬜⬛⬛⬛⬛
⬛⬛⬛⬛⬜⬛⬜⬛⬛⬛⬛⬛⬜⬛⬜⬛⬛⬛⬛
⬛⬛⬛⬛⬜⬛⬜⬜⬜🍒⬜⬜⬜⬛⬜⬛⬛⬛⬛
⬛⬛⬛⬛⬜⬜⬜⬛⬛⬛⬛⬛⬜⬜⬜⬛⬛⬛⬛
⬛⬜⬜⬜⬜⬜⬜⬜⬜⬛⬜⬜⬜⬜⬜⬜⬜⬜⬛
⬛⬜⬛⬛⬜⬛⬛⬛⬜⬛⬜⬛⬛⬛⬜⬛⬛⬜⬛
⬛⬜⬜⬛⬜⬜⬜⬜⬜⬜⬜⬜⬜⬜⬜⬛⬜⬜⬛
⬛⬛⬜⬛⬜⬛⬜⬛⬛⬛⬛⬛⬜⬛⬜⬛⬜⬛⬛
⬛⬜⬜⬜⬜⬛⬜⬜⬜⬛⬜⬜⬜⬛⬜⬜⬜⬜⬛
⬛⬜⬛⬛⬛⬛⬛⬛⬜⬛⬜⬛⬛⬛⬛⬛⬛⬜⬛
⬛⬜⬜⬜⬜⬜⬜⬜⬜⬜⬜⬜⬜⬜⬜⬜⬜⬜⬛
⬛⬛⬛⬛⬛⬛⬛⬛⬛⬛⬛⬛⬛⬛⬛⬛⬛⬛⬛