⬛⬛⬛⬛⬛⬛⬛⬛⬛⬛⬛⬛⬛⬛⬛⬛⬛⬛⬛
⬛😐⬜⬜⬜⬜⬜⬜⬜⬛⬜⬜⬜⬜⬜⬜⬜⬜⬛
⬛⬜⬛⬛⬜⬛⬛⬛⬜⬛⬜⬛⬛⬛⬜⬛⬛⬜⬛
⬛⬜⬛⬛⬜⬛⬛⬛⬜⬛⬜⬛⬛⬛⬜⬛⬛⬜⬛
⬛⬜⬜⬜⬜⬜⬜⬜⬜🍎⬜⬜⬜⬜⬜⬜⬜⬜⬛
⬛⬜⬛⬛⬜⬛⬜⬛⬛⬛⬛⬛⬜⬛⬜⬛⬛⬜⬛
⬛🍎⬜⬜⬜⬛⬜⬜⬜⬛⬜⬜⬜⬛⬜⬜⬜🍎⬛
⬛⬛⬛⬛⬜⬛⬛⬛⬜⬛⬜⬛⬛⬛⬜⬛⬛⬛⬛
⬛⬛⬛⬛⬜⬛⬜⬜⬜🍎⬜⬜⬜⬛⬜⬛⬛⬛⬛
⬛⬛⬛⬛⬜⬜⬜⬜⬜⬜⬜⬜⬜⬜⬜⬛⬛⬛⬛
💛⬜⬜⬜⬜⬛⬜⬜⬜⬜😈⬜⬜⬛⬜⬜⬜⬜💛
⬛⬛⬛⬛⬜⬛⬜⬜😡⭐📘⬜⬜⬛⬜⬛⬛⬛⬛
⬛⬛⬛⬛⬜⬛⬜⬛⬛⬛⬛⬛⬜⬛⬜⬛⬛⬛⬛
⬛⬛⬛⬛⬜⬛⬜⬜⬜🍒⬜⬜⬜⬛⬜⬛⬛⬛⬛
⬛⬛⬛⬛⬜⬜⬜⬛⬛⬛⬛⬛⬜⬜⬜⬛⬛⬛⬛
⬛⬜⬜⬜⬜⬜⬜⬜⬜⬛⬜⬜⬜⬜⬜⬜⬜⬜⬛
⬛⬜⬛⬛⬜⬛⬛⬛⬜⬛⬜⬛⬛⬛⬜⬛⬛⬜⬛
⬛⬜⬜⬛🍎⬜⬜⬜⬜🍎⬜⬜⬜⬜🍎⬛⬜⬜⬛
⬛⬛⬜⬛⬜⬛⬜⬛⬛⬛⬛⬛⬜⬛⬜⬛⬜⬛⬛
⬛⬜⬜⬜⬜⬛⬜⬜⬜⬛⬜⬜⬜⬛⬜⬜⬜⬜⬛
⬛⬜⬛⬛⬛⬛⬛⬛⬜⬛⬜⬛⬛⬛⬛⬛⬛⬜⬛
⬛🍎⬜⬜⬜⬜⬜⬜⬜⬜⬜⬜⬜⬜⬜⬜⬜🍎⬛
⬛⬛⬛⬛⬛⬛⬛⬛⬛⬛⬛⬛⬛⬛⬛⬛⬛⬛⬛